|--------|
|.F.|..-.|
|.._|.@P.|
|..F...-.|
|--------|
